#####B#
##### #
##### #
####  #
#### ##
     ##
A######